#################
#     k         #############
#k              |    |     *#
#       @      ##############
#################
