#################
#   e k         #############
#k              |    |     *#
#       @      ##############
##### ###########
    # ###
   ##   #
   #   ##
   #####
