#################
#               # 
#               #
#              ##
#################
