#################            
#     k         #############
#k              |    |     *#
#       @      ##############
##### ###########            
    # ##                     
    #   #                    
   #   ##                    
   #####                     
