#################
#     k         #############
#               |          *#
#       @      ##############
#################
